_ _ _ _ _ _ _ 
_ W _ W _ W _ 
_ R R R _ _ _ 
_ W _ W _ W _ 
_ _ F1 _ DU _ _ 
R W _ W _ W _ 
_ _ _ _ _ _ _ 
