_ R _ _ _ _ _
DR _ _ W _ W DL
_ _ R R _ _ _
_ W _ W _ W _
_ _ _ _ DU _ _
R W _ W _ W _
_ _ _ _ _ _ _
